NO img/wall.xpm
EA img/wall.xpm
WE img/wall.xpm
SO img/wall.xpm

F 220,100,0
C 225,30,0

        1111111111111111111111111        1111111111111111111111111
        1000000000110000000000001        1000000000110000000000001
        1011000001110000000000001        1011000001110000000000001
        1001000000000000000000001        1001000000000000000000001
111111111011000001110000000000001111111111011000001110000000000001
1N0000000011000001110111111111111100000000011000001110111111111111
1111011111111101110000001000111000011111111011100000010001
1111011111111101110101001000111111111111111011101010010001
1100000011010101110000001010111010100110101011100000010001
1000000000000000110000001000110000000000000001100000010001
1000000000000000110101001000110000000000000001101010010001
1100000111010101111101111000111110001111101011111101111011
11110111 1110101 10111101000111110111 1110101 101111010001
11111111 1111111 11111111111111111111 1111111 111111111111
1111011111111101110000001000111000011111111011100000010001
1111011111111101110101001000111111111111111011101010010001
1100000011010101110000001010111010100110101011100000010001
1000000000000000110000001000110000000000000001100000010001
1000000000000000110101001010110000000000000001101010010001
1100000111010101111101111000111110001111101011111101111011
10110111 1110101 10111101000111110111 1110101 101111010001
11111111 1111111 11111111111111111111 1111111 111111111111