NO img/wall.xpm
EA img/wall.xpm
WE img/wall.xpm
SO img/wall.xpm

F 220,100,0
C 225,30,0

        1111111111111111111111111        1111111111111111111111111
        1000000000110000000000001        1000000000110000000000001
        1011000001110000000000001        1011000001110000000000001
        1001000000000000000000001        1001000000000000000000001
111111111011000001110000000000001111111111011000001110000000000001
100000000011000001110111111111111100000000011000001110111111111111
111101111111110111000000100011100001111111101110000001000101000101
111101111111110111010100100011111111111111101110101001000101000101
110000001101010111000000101011101010011010101110000001000101000101
100000000000000011000000100011000000000000000110000001000101000101
100000000000000011010100100011000000000000000110101001000101000101
110000011101010111110111100011111000111110101111110111101111101111
11110111 1110101 10111101000111110111 1110101 10111101000101000101
11111111 1111111 11111111111111111111 1111111 11111111111111111111
111101111111110111000000100011100001111111101110000001000101000101
111101111111110111010100100011111111111111101110101001000101000101
110000001101010111000000101011101010011010101110000001000101000101
100000000000000011000000100011000000000000000110000001000101000101
100000000000000011010100101011000000000000000110101001000101000101
110000011101010111110111100011111000111110101111110111101111101111
1N110111 1110101 10111101000111110111 1110101 10111101000101001001
11111111 1111111 11111111111111111111 1111111 11111111111111111111